1111111111111111111111111111111111
10000000000000C00000C0000000000011
1010010100100000101001001C00010101
1010010010101010001001000100010101
10000000C00C1000000000000000000C01
10000000000000C00000C0000100000001
1010010100100000101001000000010101
1010010010101010001001000000010101
10000000C00C1000000000000C00000C11
1E0000000000000C00000C00000C000001
1010010100100000101001000100010101
1010010010101010001001000001110101
1P0000000C00C100000000000C000000C1
1111111111111111111111111111111111