1111111111111111111111111111111111
1E0000000000000C00000C000000000001
1010010100100000101001000000010101
1010010011101010001001000000010101
10000P001C10C1000000000000000000C1
1111111111111111111111111111111111